nama_kecamatan,jumlah_pus,jml_pus_kps_ksi,persentase_pus_kps_ks1,jml_pus_jkn_penerima_bantuan,persentase_pus_jkn_terima_bantuan,jml_pus_jkn_bukan_penerima_bantuan,persentase_pus_jkn_bukan_penerima_bantuan,jml_pus_jkn,persentase_pus_jkn
Sukasari,8851,3627,40.98,0,0.00,0,0.00,0,0.00
Coblong,16243,7055,43.43,0,0.00,0,0.00,0,0.00
Babakan Ciparay,21491,8293,38.59,8094,37.66,13292,61.85,21386,99.51
Bojongloa Kaler,17529,7881,44.96,7544,43.04,9985,56.96,17529,100.00
Andir,19570,8059,41.18,4444,22.71,0,0.00,4444,22.71
Cicendo,14905,7881,52.87,0,0.00,14895,99.93,14895,99.93
Sukajadi,16420,4937,30.07,0,0.00,0,0.00,0,0.00
Cidadap,7419,2541,34.25,2540,34.24,0,0.00,2540,34.24
Bandung Wetan,5095,2128,41.77,0,0.00,0,0.00,0,0.00
Astana Anyar,9459,2269,23.99,0,0.00,0,0.00,0,0.00
Regol,14810,4862,32.83,0,0.00,0,0.00,0,0.00
Batununggal,16549,9305,56.23,0,0.00,0,0.00,0,0.00
Lengkong,14998,5769,38.47,1973,13.16,13025,86.84,14998,100.00
Cibeunying Kidul,17362,9243,53.24,7851,45.22,9453,54.45,17304,99.67
Bandung Kulon,14791,10558,71.38,5406,36.55,5384,36.40,10790,72.95
Kiaracondong,15132,8772,57.97,0,0.00,0,0.00,0,0.00
Bojongloa Kidul,12018,5427,45.16,2102,17.49,8972,74.65,11074,92.15
Cibeunying Kaler,10423,1992,19.11,3115,29.89,6104,58.56,9219,88.45
Sumur Bandung,6433,4061,63.13,0,0.00,0,0.00,0,0.00
Antapani,9926,1340,13.50,0,0.00,0,0.00,0,0.00
Bandung Kidul,4263,1907,44.73,1864,43.73,2399,56.27,4263,100.00
Buahbatu,11457,2168,18.92,0,0.00,0,0.00,0,0.00
Rancasari,9991,2317,23.19,1419,14.20,140,1.40,1559,15.60
Arcamanik,8522,3227,37.87,0,0.00,0,0.00,0,0.00
Cibiru,9542,3426,35.90,1296,13.58,2330,24.42,3626,38.00
Ujung Berung,17290,15096,87.31,2223,12.86,0,0.00,2223,12.86
Gedebage,8779,2753,31.36,656,7.47,4713,53.68,5369,61.16
Panyileukan,5689,1427,25.08,716,12.59,711,12.50,1427,25.08
Cinambo,4120,1497,36.33,777,18.86,1511,36.67,2288,55.53
Mandalajati,11176,4039,36.14,4039,36.14,6957,62.25,10996,98.39
