nama_kecamatan,jumlah_pus,jml_pus_kps_ksi,persentase_pus_kps_ks1,jml_pus_jkn_penerima_bantuan,persentase_pus_jkn_terima_bantuan,jml_pus_jkn_bukan_penerima_bantuan,persentase_pus_jkn_bukan_penerima_bantuan,jml_pus_jkn,persentase_pus_jkn
Sukasari,7790,1562,20.05,0,0.00,0,0.00,0,0.00
Coblong,13532,2971,21.96,0,0.00,0,0.00,0,0.00
Babakan Ciparay,21590,4233,19.61,325,1.51,0,0.00,325,1.51
Bojongloa Kaler,17510,7877,44.99,7534,43.03,9057,51.72,16591,94.75
Andir,14030,3706,26.41,0,0.00,0,0.00,0,0.00
Cicendo,11684,6213,53.18,0,0.00,6213,53.18,6213,53.18
Sukajadi,16304,4884,29.96,0,0.00,0,0.00,0,0.00
Cidadap,7384,2483,33.63,0,0.00,0,0.00,0,0.00
Bandung Wetan,4884,1327,27.17,0,0.00,0,0.00,0,0.00
Astana Anyar,9105,4294,47.16,0,0.00,0,0.00,0,0.00
Regol,14810,4862,32.83,0,0.00,0,0.00,0,0.00
Batununggal,16222,9305,57.36,0,0.00,0,0.00,0,0.00
Lengkong,14960,5866,39.21,1970,13.17,12990,86.83,14960,100.00
Cibeunying Kidul,16882,7550,44.72,7520,44.54,9362,55.46,16882,100.00
Bandung Kulon,17223,13966,81.09,6229,36.17,7241,42.04,13470,78.21
Kiaracondong,14783,8717,58.97,142,0.96,42,0.28,184,1.24
Bojongloa Kidul,11926,5419,45.44,2102,17.63,8972,75.23,11074,92.86
Cibeunying Kaler,9624,1993,20.71,4110,42.71,4985,51.80,9095,94.50
Sumur Bandung,5256,2134,40.60,0,0.00,0,0.00,0,0.00
Antapani,9763,1307,13.39,0,0.00,0,0.00,0,0.00
Bandung Kidul,7837,2971,37.91,2971,37.91,4866,62.09,7837,100.00
Buahbatu,18288,3189,17.44,0,0.00,0,0.00,0,0.00
Rancasari,9929,1557,15.68,1417,14.27,140,1.41,1557,15.68
Arcamanik,8460,3217,38.03,0,0.00,0,0.00,0,0.00
Cibiru,9490,3426,36.10,1306,13.76,2315,24.39,3621,38.16
Ujung Berung,19198,14787,77.02,2096,10.92,0,0.00,2096,10.92
Gedebage,7925,2753,34.74,570,7.19,5061,63.86,5631,71.05
Panyileukan,5288,1456,27.53,714,13.50,742,14.03,1456,27.53
Cinambo,4087,1497,36.63,777,19.01,1511,36.97,2288,55.98
Mandalajati,10578,2787,26.35,2787,26.35,7791,73.65,10578,100.00
