NO,MATA PENCAHARIAN,WNI LAKI-LAKI,WNI PEREMPUAN,JUMLAH WNI,WNA LAKI-LAKI,WNI PEREMPUAN,JUMLAH  WNA,JUMLAH LAKI-LAKI,JUMLAH PEREMPUAN,JUMLAH  
1,Pegawai Negeri Sipil,1359,801,2160,0,0,0,1359,801,2160
2,TNI / POLRI,284,2,286,0,0,0,284,2,286
3,Pegawai Swasta,8479,7008,15487,18,8,26,8497,7016,15513
4,Tani,175,75,250,0,0,0,175,75,250
5,Dagang,6173,4485,10658,0,0,0,6173,4485,10658
6,Pelajar,9544,8702,18246,1,1,2,9545,8703,18248
7,Mahasiswa,1835,1558,3393,0,0,0,1835,1558,3393
8,Pensiunan,638,509,1147,0,0,0,638,509,1147
9,Lain-lain,10080,13324,23404,0,0,0,10080,13324,23404
,JUMLAH,38567,36464,75031,19,9,28,38586,36473,75059
