NO,KELOMPOK UMUR,WNI LAKI-LAKI,WNI PEREMPUAN,JUMLAH  WNI,WNA LAKI-LAKI,WNI PEREMPUAN,JUMLAH WNA,JUMLAH LAKI-LAKI,JUMLAH PEREMPUAN,TOTAL KESELURUHAN
1,0  s/d  4,3624,3490,7114,0,0,0,3624,3490,7114
2,5  s/d  9,3434,2957,6391,1,1,2,3435,2958,6393
3,10  s/d  14,3428,3145,6573,0,0,0,3428,3145,6573
4,15  s/d  19,3266,3175,6441,0,0,0,3266,3175,6441
5,20  s/d  24,3368,3259,6627,3,1,4,3371,3260,6631
6,25  s/d  29,3515,3347,6862,1,1,2,3516,3348,6864
7,30  s/d  34,3577,3370,6947,7,3,10,3584,3373,6957
8,35  s/d  39,3013,2980,5993,3,2,5,3016,2982,5998
9,40  s/d  44,2574,2515,5089,3,1,4,2577,2516,5093
10,45  s/d  49,2450,2347,4797,0,0,0,2450,2347,4797
11,50  s/d  54,1891,1793,3684,1,0,1,1892,1793,3685
12,55  s/d  59,1825,1651,3476,0,0,0,1825,1651,3476
13,60  s/d  64,1362,1248,2610,0,0,0,1362,1248,2610
14,65 - keatas,1240,1187,2427,0,0,0,1240,1187,2427
,JUMLAH,38567,36464,75031,19,9,28,38586,36473,75059
