nama_kecamatan,jumlah_pus,jml_pus_kps_ksi,persentase_pus_kps_ks1,jml_pus_jkn_penerima_bantuan,persentase_pus_jkn_terima_bantuan,jml_pus_jkn_bukan_penerima_bantuan,persentase_pus_jkn_bukan_penerima_bantuan,jml_pus_jkn,persentase_pus_jkn
Sukasari,8952,3561,39.78,0,0.00,0,0.00,0,0.00
Coblong,16773,6765,40.33,56,0.33,45,0.27,101,0.60
Babakan Ciparay,21579,8388,38.87,8192,37.96,13387,62.04,21579,100.00
Bojongloa Kaler,17547,7899,45.02,7622,43.44,9813,55.92,17435,99.36
Andir,14353,10647,74.18,9728,67.78,7,0.05,9735,67.83
Cicendo,13908,9537,68.57,0,0.00,13908,100.00,13908,100.00
Sukajadi,16719,5056,30.24,0,0.00,0,0.00,0,0.00
Cidadap,8198,2625,32.02,2623,32.00,4689,57.20,7312,89.19
Bandung Wetan,4732,2036,43.03,0,0.00,0,0.00,0,0.00
Astana Anyar,9765,2389,24.46,0,0.00,0,0.00,0,0.00
Regol,12215,3666,30.01,3666,30.01,8549,69.99,12215,100.00
Batununggal,17240,9305,53.97,0,0.00,0,0.00,0,0.00
Lengkong,7418,3178,42.84,418,5.63,6994,94.28,7412,99.92
Cibeunying Kidul,17482,12681,72.54,7043,40.29,9956,56.95,16999,97.24
Bandung Kulon,13690,9681,70.72,4405,32.18,4070,29.73,8475,61.91
Kiaracondong,19360,10044,51.88,0,0.00,0,0.00,0,0.00
Bojongloa Kidul,12132,4927,40.61,2102,17.33,8972,73.95,11074,91.28
Cibeunying Kaler,10217,1892,18.52,1761,17.24,8456,82.76,10217,100.00
Sumur Bandung,3646,583,15.99,0,0.00,0,0.00,0,0.00
Antapani,10172,1401,13.77,0,0.00,0,0.00,0,0.00
Bandung Kidul,4314,1852,42.93,1803,41.79,2341,54.27,4144,96.06
Buahbatu,11925,2271,19.04,0,0.00,0,0.00,0,0.00
Rancasari,12949,2547,19.67,2327,17.97,220,1.70,2547,19.67
Arcamanik,8699,3267,37.56,0,0.00,0,0.00,0,0.00
Cibiru,9681,3522,36.38,1365,14.10,2369,24.47,3734,38.57
Ujung Berung,20774,16929,81.49,5473,26.35,6136,29.54,11609,55.88
Gedebage,7323,2782,37.99,576,7.87,4660,63.64,5236,71.50
Panyileukan,5685,1421,25.00,788,13.86,633,11.13,1421,25.00
Cinambo,4415,1498,33.93,777,17.60,1511,34.22,2288,51.82
Mandalajati,11342,4259,37.55,4258,37.54,7083,62.45,11341,99.99
